ruffien == ond. hruf = mna. ruf = ant. nord. rufa (scabies)
(Diez ).
ruisseler -.- und. rieseln (Hiillmann).

sae = goth. saccus = nna. sack, unde: zachee, sachelet‚
sachet‚ sachette8‚ saequier.

saccage == ital. sacco (expilatio) = and. s-cah (rapina,
expilatio), unde: saccagement‚ saceager‚ saccageur.

safre (homo fastidii delicati) = goth. satjau (gustare) a:
subet. safareis ( homo subtilis palati).

saisir = goth. satjau = and. sezjan = und. setzen, unde:
salsi, same, saissisablffi misissent, saisissement.
salope = and. salawer (sordidus, immundus), undo dcxiv.

sale = and. salo et salow (niger, immundus), unde: salope-
ment‚ saloperie 3 sale, salement‚ salete.

sabre = und. sabel.

salle = ana. sal = nna. saal, unde: salon.

saule τ·- and. salaba === contr. sala π pronunciat. stila (Diez).

sau rer = and. sfiren et sauren = i. e. d6rren.

savon = m1at.sapo = goth. saifa = and. seifa = nhd. seife‚
unde: savonnage‚ summer, savonnerie‚ savonnette, sa-
vonneur‚ semonnia, iere.

semale sive semaque = bat. ung. smak = smulxe (navis
bolland.).

senechal == ital. sinisealeo = and. sini-sealh.

seran == med. bat. ling. s-ch-rantsen -·-- aad. schram == mna.
schrenzen et sranz (hami ferrei).

seuil = «1121. pop. siin -ε sulle (i. ο. limen).

sigler afrg³ = ant. nord. sigla = and. segal, oonf. cingler.

sillon = nord. sila (sulcus), undo: silonne, silonner2

soda = sieden = perf. sottl’

soie = nnat. seta = prov. seda = aad. sida -τ aha. seide.

sois = aba. suf: ant. nord. sup (jue, sorbillum) == ιιιια. soff.
6·

