-80—

preuve = serm. pop. priiwe = nna. ptfobe?
preuver =' serm. pop. priiwen = probem sive a verbo pro-
bare.

pr'oue = ital. prua (prior pars navis) = aud. proth‚ prol-t,
brort (Diez). ’

pulier (glomerare) = angl. sax. pullian = angl. pull (tra-
here) = pull ¹to (glomerare) (Diez).

quenoubille = mlat. cohucula = and. kuncla (colus) = nhd.
kunkel. ’

quille = apd. kiol (cuneus) = ant. nord. kifil = nhd. kiel, unde:
quillage.

quille = and. kegil = ιιιιᾱ. kegel (conus); unde: quiller‚
quillier‚ quillon, quillette.

rac'aille <perditi homines) = m„ nora. raki (canis) =
nna. raeker3 (racaille a verbo raki, ut canaille a verbo oanis
form. esse videtur).

race = ml. razza = angl. ung. race (linea et genus) = and.
reizza (linea) = nhd. teies-(feder), ί. e. linien-feder. ,

racher arx-gs = ant. nord. hraki (sputum) = angl. sax. hraekan,
unde: cracher (Diez).

,rafle = ahd- drappo (racemus) = ιιιιᾱ. rapp3 conr. grappe!

rafl er = and. rafsjan eive refsjan (corripere) = nhd.
(weg)raffen.

raguer = nord. raka (terere) (Diez).

raimbaut = ὡς. reimbald = and. regimbald (n. pr.) ’

rain = aba. rain (margo) = nhd. rand et rain (se. silvae).

raler =-.. angl. ung. rattle = bat. ung. ratelen = nhd. rasseln.

ramequin = nhd. rahm (Menage).

rame = und. rahmen (forma„margo), unde: ramette.

