*424—

airer = goth. ara = and. aro (aquila), unde: νὴ. germ. aren
= 1. 0. horsten = nisten (nidum fingere).
aise = goth. aze-ts (commodus, facilis) = prov. ais = im.

·asio = agio.

⁹ alcove = alah-kovo = ιιιια. kofen (habitatio) (Grimm).

alenc = mg. alesne = and. alnsa sive alansa sive-ala (su-
bula) = und. ahle.

aleu mg. = and. alssd sive alodis (Diez)‚ mlat. allodium.

algier et algeir (hasta) ε, aha. azger = ant. ιιοια. atgeirr
(Grimm). »

allemand = Allemannen.

alose = aha. alausa sive alosa = aha. alose = alse = else.

a-madouer = ant. nord. mata = dan. ung. made = goth. mat-

Jan (edere) (Βία).

am arrer = and. marrjan = angl. sax. merran (impedire),
unde: amarrage‚ demarrer eto.

am b as 5 a d 6 .

ambassadeur = goth. andbaht = and. ambaht = nhd. amt.

s'amuser = conf. muser!
anche (tubus) = ahd. ancha (tibia, crus) (Diez).

an garde = i. e. aufe-garde (vorhut), conf. garde.
arban = afrg. harban = and. heriban = nhd. heerbann.

archambaud = and. erchambald.
arguar = and. arah6n (nectere) (Grimm).

armand = and. herman.

. Varm&e = proxime ex verbo armatus = arma = ex ant. teut. arm
= m. armus, unde transpos.: ramus (Grimm. Lex. ΙΙΙ.)

arnaud = and. arnulf.

ar-ramir = goth. hramjan (cruci affigere), conr. aha. ramea
(petere) (Grimm).

ar-ran ger = and. ranc = nhd. ring = ringen (cir-

arrangement cum agere).

ar-riser = goth. risan = and. risan (cadere, incidere).

aselle = und. (wasser)-assel‚ unam asellotes. ⁸

