—ssg-

guider = goth. vithan = aud. wetan3 sive a v. and. weid6u
(pascere, venari) = nhd. weiden‚ unde: guide‚ guidon.

guigner = ahu. winkan vioe winchjan = und. winken (signa
dare nutu oculisque).

guilee = and. wasal (imber) (Diez).

guillot (anser pinguis) = ahu. wibil (Diez).

guillaume = unat. guilelmus = ιιιιᾱ. wilhelm.

guim pe = mlat. wimpla (du Gange) = angl. wimple = ahu.
wimpal (theristrum) = mhd. wimpel (vexillum nauticum),
unde: guimper.

guinde = ahu. winta = nna. winde (trochlea).

gu-inder = and. wintan = nhd. winden, unde: guinde, guin-
dard, guindeau, guinderesse5 guinderie3 guindre.

guip er = goth. veipan = and. wiffau (texere) = und. wei· -
fen, unde: guipeuse, guipoir‚ guipon, guipure.

guirlande = and. wiara (corona) = mnu. wieren (Frisch);
conf. etiam: ahu. gurtil avb. gurtjan (cingere) = num. giirte
et giirtel.

guiscart εει-ς. (versutus) = ant. nord. viskr, cont. guichel

guise = aba. wisa = nhd. weise.

guivre afrg. = aud. wippera a vei-bo vippera. v

haehe = hisp. haeha = ahu. hakko = uhu. hacke, unde:
bacher, hachereau, hachette, bachis, haehoir, hachet.

‚ hagard = angl. haggard = germ. 1. hagart = hut. nord. hebr
(Diez). Α
haie = aud. hag (oppidum) = nhd. haag i. e. gehege3 unde:

hager = nm. hegen.
haillon = mim. hadel = ιιιιᾱ. hader (Diez).
haine = and. haz = und. hass (odium).
hair = goth. hatjan = ahu. hazjan = ιιιιᾱ. hassen.
haire (cilicium) = ahu. hara = uhu. haar-(hemde). ’

