*53—

crampe = ειιᾱ. kramph sive kramf = nna. krampe = kramme
unde: erampiller‚ erampon‚ cramponner‚ cramponnet etc.

cranoelin = nna. kranzlein. ¹

erapaud = angl. ung. ereeper == εεςι. εει. creopan = ειιᾱ.
krifan = und. kriechen (serpere) (Diez).

eraquelin = kringel = i. e. brieizel (Hiillmann).

eraquer == ειιᾱ. ehrae (strepitus) et kraohon (crepare) =
und. kraehen. “

creche = ital. greppia = nhd. krippe.

eremallon, eremaillere = batav.1ing. kram (uncus, hamus)
(Diez). ’

cresson = and. kressa = und. kresse (?)

oriquet = germ. ung. kracke (equus strigosus).

croc = εωι. ehracho vel ehruoc = nord. krokr (hamus); -ε
aha. krueha = und. kriicke‚ unde: croc-en -jambe, croche,
emeher, crochet‚ crocheter‚ crochetage, oroeheteur‚ ero-
ehetoral‚ crochetier, crocheux, crocheton‚ oroqueux, ero·

, ehu, croehuer etc.

croissir = εωι. kriustan (fragorem dare). “

crouler = afrg. crosler = ειη. nord. krulla ε und. kriiu-
seln, batav. ung. krullen‚ unde: croulant, croulement‚ erou-
lier., i'ere.

eroupe (et groupe) = nord. kryppa (bulla, flexio, tergum),
unde: eroupe‚ eroupetons, croupier, croupion.

eroupir = υειεν. ling. krupen (hocken).

euve = ειιᾱ. kuba = und. kufe = (nal. pop. kiiwe.

dague = ωηεν. ling. dagg = angl. dag et dagger (pugio)
(Diez).

dalle = εωι. dola (tubus).

dandin = mea. ωιεν. ung. danten (ineptire) -= nna. tand -τ
ῐὲιιᾱΙει· = νὴ. ῐὲιιᾶθὶη (lascivire).

